#
# ~/.bashrc
#

# If not running interactively, don't do anything
[[ $- != *i* ]] && return

##Prompt##

PS1="[\u@\h \W]\$ "

##Env var##

#Editor
export EDITOR="/usr/bin/vim"

##Alias##

#Ls
alias ls="ls --color=auto"
alias ll="ls -ltr"
alias l="ls -ltrA"

#Grep
alias grep="grep --color=auto"
alias egrep="egrep --color=auto"
alias fgrep="fgrep --color=auto"

#Manipulating files
alias mv="mv -i"
alias cp="cp -i"
alias ln="ln -i"
alias rm="rm -i"

#Editor
alias vi="vim"

#Package manager
alias update="sudo pacman -Syy"
alias upgrade="sudo pacman -Syu"
alias fullupgrade="sudo pacman -Syu && yay -Syu"
alias install="sudo pacman -S"
alias remove="sudo pacman -Rns"
alias pkgsearch="pacman -Ss"
alias binsearch="pacman -F"
alias pkglist="pacman -Q"
alias aurpkglist="pacman -Qm"
alias cleancache="sudo pacman -Sc"
alias cleanaurcache="yay -Sc"
alias cleanorphans="pacman -Qtdq | sudo pacman -Rns -"

#Docker
alias dockup="sudo docker pull containrrr/watchtower && sudo docker run --rm -v /var/run/docker.sock:/var/run/docker.sock containrrr/watchtower --cleanup --run-once"

#Sudo
alias sudo="sudo "
